11111111111111111111111111111111111111
1                 11                 1
1 9 0 0 0 0 0 0 0 11 0 0 0 0 0 0 0 9 1
1                 11                 1
1   1111 0 1111 0 11 0 1111 0 1111   1
1 0 1111 0 1111 0    0 1111 0 1111 0 1
1                                    1
1 0 0 0 0 0 0 0 0  0 0 0 0 0 0 0 0 0 1
1                                    1
1 0 1111 0 1 0 0 111111 0 1 0 1111 0 1
1          1 0 0 1      0 1          1
1 0 0  0 0 1     1 0 0 0  1 0 0  0 0 1
1          111   1 0 0  111          1
1 0 0  0 0 1   0   0 0 0  1 0 0  0 0 1
1                                    1
1 0 0 0 0 0 0 0 0  0 0 0 0 0 0 0 0 0 1
1                                    1
111111                          111111
              111    111              
  80 0 0 0 0  1        1  0 0 0 0 07  
              1        1              
1111111 0 1 0 1        1 0 1 0 1111111
1         1   1        1   1         1
1       0 1 0 1        1 0 1 0       1
1 0 0 0   1   1111111111   1   0 0 0 1
1       0 1 0            0 1 0       1
1  0 0 0 0 0 0          0 0 0 0 0 0  1
1       0   0  1111111   0   0       1
1 0 0 0           1            0 0 0 1
1                 1                  1
1 0 1111   1111   1   1111   11111 0 1
1      1                     1       1
1 0  0 1 0 0 0 0 0 0 0 0 0 0 1  0  0 1
1      1                     1       1
1111 0 1   1111111111111   0 1   11111
1                1                   1
1 0 0 0 0 0 0 0  1  0 0 0 0 0 0 0 0  1
1                1                   1
1 0 1111111111   1   1111111111  0 0 1
1                                    1
1 9 0 0 0 0 0 0 0  0 0 0 0 0 0 0 0 9 1
1                                    1
11111111111111111111111111111111111111